Level 1
  #####
###   #
# $ # ##
# #  . #
#    # #
## #   #
 #@  ###
 #####

Level 2
  #####
###   #
# $ # ##
# #  . #
#    # #
##$#.  #
 #@  ###
 #####

Level 3
  #####
###   #
# $ # ##
# #  . #
# .  # #
##$#.$ #
 #@  ###
 #####

Level 4
    ####
#####  #
#   $  #
#  .#  #
## ## ##
#      #
# @#   #
#  #####
####

Level 5
    ####
#####  #
#   $  #
# *.#  #
## ## ##
#      #
# @#   #
#  #####
####

Level 6
    ####
#####  #
#   *  #
# *.#  #
## ## ##
# $    #
# @#   #
#  #####
####

Level 7
 #####
 #   ##
## #$ ##
# $    #
#. .#  #
### @ ##
  # # #
  #   #
  #####

Level 17
###############
#             #
# $.$.$.$.$.$ #
# .$.$.#.$.$. #
# $.$.$ $.$.$ #
# .$.$.#.$.$. #
# $.$.$ $.$.$ #
# .# # @ # #. #
# $.$.$ $.$.$ #
# .$.$.#.$.$. #
# $.$.$ $.$.$ #
# .$.$.#.$.$. #
# $.$.$.$.$.$ #
#             #
###############

Level 18
 ###############
##  #   #   #  ##
#   **.. ..**   #
#  *   $$$   *  #
##* .### ###. *##
# * ## $@$ ## * #
# . #       # . #
# .$#$ ### $#$. #
## $   # #   $ ##
# .$#$ ### $#$. #
# . #       # . #
# * ## $ $ ## * #
##* .### ###. *##
#  *   $$$   *  #
#   **.. ..**   #
##  #   #   #  ##
 ###############


 Level 19
  #########
  #   *   #
  # ## ## #
  #  * *  #
 ###  #  ###
 #  .$#$.  #
 # #  @  # #
 #  .$#$.  #
 ###  #  ###
   #######

 Level 20
 ####
 #  #########
 #    ##    #
 # $$$#     #
 ##...# #$$$#
  #...# #...#
  #$$$  #...##
  #    ##$$$ #
  ####### @  #
        ######

 Level 21
   #########
  ##   #   #
 ## $# # #$###
 #   #. .#   #
 # $ *.@.* $ #
 #   #. .#   #
 ###$# # #$ ##
   #   #   ##
   #########

 Level 22
   ####  ####
   #  ####  ####
 ###     $ $   #
 #    # $  *...##
 # $ # #### #.. #
 ##   #         #
  # $$ $$@ #...##
  #   #  #######
  ####   # #
     #####

 Level 23
        ####
   ######  #
  ##  $  $ #
 ##  $ #$  #
 #  $ #   $#
 #   # ##  ##
 ###$  ..#  #
   #  #*...@#
   #   ..####
   #  ####
   ####